TTTTTTTTT
T       T
T   K   T
T       T
T  R    .
T       T
T    K  T
T       T
TTTTTTTTT